111111111111111111111111111111
1E0000000000C1000000C000110001
111000000111111110111110010001
11C000001010100100110000011111
1111001110000E1011010011011111
1100E0000111101000C10000011111
111011111000000011001101110001
111000010011C10000001001011001
111110101000000010011101110101
1PE000001110011100010000110E01
111111111111111111111111111111
111111111111111111111111111111