11111111
1PECEEE1
1EEEEEE1
1EEEEEE1
1EEEEEE1
1EEEEEE1
1EEEEEE1
1EEEEEE1
1EEEEEE1
1EEEEEE1
1EEEPEE1
1EEEEEE1
1EEEEEC1
1EEEEEE1
1EEEEEE1
1EEEEEE1
1EEEEEE1
1EEEEEE1
1EEEEEE1
1EEEEEE1
1EEEEEE1
1EEEEEE1
1EEEEEE1
1EEEEEE1
1EEEEEE1
1EEEEEE1
1EEEEEE1
1EEEEEE1
1EEEEEE1
1EEEEEE1
1EEEEEE1
1EEEEEE1
1EEEEEE1
1EEEEEE1
1EEEEEE1
1EEEEEE1
1EEEEEE1
1EEEEEE1
1EEEEEE1
1EEEEEE1
1EEEEEE1
1EEEEEE1
1EEEEEE1
1EEEEEE1
1EEEEEE1
1EEEEEE1
1EEEEEE1
1EEEEEE1
1EEEEEE1
1EEEEEE1
1EEEEEE1
1EEEEEE1
1EEEEEE1
1EEEEEE1
1EEEEEE1
1EEEEEE1
1EEEEEE1
1EEEEEE1
1EEEEEE1
1EEEEEE1
1EEEEEE1
1EEEEEE1
1EEEEEE1
1EEEEEE1
1EEEEEE1
1EEEEEE1
1EEEEEE1
1EEEEEE1
1EEEEEE1
1EEEEEE1
1EEEEEE1
1EEEEEE1
1EEEEEE1
1EEEEEE1
1EEEEEE1
1EEEEEE1
1EEEEEE1
1EEEEEE1
1EEEEEE1
1EEEEEE1
1EEEEEE1
1EEEEEE1
1EEEEEE1
1EEEEEE1
1EEEEEE1
1EEEEEE1
1EEEEEE1
1EEEEEE1
1EEEEEE1
1EEEEEE1
1EEEEEE1
1EEEEEE1
1EEEEEE1
1EEEEEE1
1EEEEEE1
1EEEEEE1
1EEEEEE1
1EEEEEE1
1EEEEEE1
1EEEEEE1
1EEEEEE1
1EEEEEE1
1EEEEEE1
1EEEEEE1
1EEEEEE1
1EEEEEE1
1EEEEEE1
1EEEEEE1
1EEEEEE1
1EEEEEE1
1EEEEEE1
1EEEEEE1
1EEEEEE1
1EEEEEE1
1EEEEEE1
1EEEEEE1
1EEEEEE1
1EEEEEE1
1EEEEEE1
1EEEEEE1
1EEEEEE1
1EEEEEE1
1EEEEEE1
1EEEEEE1
1EEEEEE1
1EEEEEE1
1EEEEEE1
1EEEEEE1
1EEEEEE1
1EEEEEE1
1EEEEEE1
1EEEEEE1
1EEEEEE1
1EEEEEE1
1EEEEEE1
1EEEEEE1
1EEEEEE1
1EEEEEE1
1EEEEEE1
1EEEEEE1
1EEEEEE1
1EEEEEE1
1EEEEEE1
1EEEEEE1
1EEEEEE1
1EEEEEE1
1EEEEEE1
1EEEEEE1
1EEEEEE1
1EEEEEE1
1EEEEEE1
1EEEEEE1
1EEEEEE1
1EEEEEE1
1EEEEEE1
1EEEEEE1
1EEEEEE1
1EEEEEE1
1EEEEEE1
1EEEEEE1
1EEEEEE1
1EEEEEE1
1EEEEEE1
1EEEEEE1
1EEEEEE1
1EEEEEE1
1EEEEEE1
1EEEEEE1
1EEEEEE1
1EEEEEE1
1EEEEEE1
1EEEEEE1
1EEEEEE1
1EEEEEE1
1EEEEEE1
1EEEEEE1
1EEEEEE1
1EEEEEE1
1EEEEEE1
1EEEEEE1
1EEEEEE1
1EEEEEE1
1EEEEEE1
1EEEEEE1
1EEEEEE1
1EEEEEE1
1EEEEEE1
1EEEEEE1
1EEEEEE1
1EEEEEE1
1EEEEEE1
1EEEEEE1
1EEEEEE1
1EEEEEE1
1EEEEEE1
1EEEEEE1
1EEEEEE1
1EEEEEE1
1EEEEEE1
11111111